1tttttttt5tttttttt2
l........m........r
l.ui.uhi.m.uhi.ui.r
lFpo.pho.e.pho.poFr
l........*........r
l.jk.f.jh5hk.f.jk.r
l....m...m...m....r
4bb2.jhk.e.jhk.1bb3
///l.m..B#...m.r///
ttt3.e.ukdji.e.4ttt
////...mPICm...////
bbb2.f.phhho.f.1bbb
///l.m.......m.r///
1tt3.e.jh5hk.e.4tt2
l........m........r
l.ji.jhk.e.jhk.uk.r
lF.m...........m.Fr
jk.e.f.jh5hk.f.e.jk
l....m...m...m....r
l.jhh6hk.e.jh6hhk.r
l.................r
4bbbbbbbbbbbbbbbbb3